2

1
6 8
110111
110111
100111
101111
100011
110001
110111
111111

1
8 7
11011101
10011101
10111101
10001111
11000101
11011101
11111101